@ legend: #=wall .=floor D=door S=secret ?=trap ~=water
@ size: 40x16
########################################
#......D..............#...............#
#..#######..####..###.#..####...####..#
#..#.....#..#..#..#...#..#..#...#..#..#
#..#.S...#..#..#..#...#..#..#...#..#..#
#..#.....####..####...#..####...#..#..#
#..####D..............#...........#...#
#.....................#...............#
########################################
